Kingdom of Poland: Kings of Poland(Piast) arms
duchy of Wielkopolska: Voivodeship of Wielkopolska arms
Poznan: Voivodeship of Poznan arms
Kalisz: Voivodeship of Kalisz arms, alternatively Zaremba arms or Paniewic/Niesobia arms
Gnienzno: Sreniawa arms(arms could also be used for Przemysl(Kmita branch))
duchy of Silesia: dukes of Silesia(Piast) arms
Opole: dukes of Opole(Piast) arms
Wroclaw: dukes of Wroclaw(Piast) arms
Glogow: dukes of Glogow(Piast) arms
Ratibor: dukes of Legnica(Piast) arms
Legnica: dukes of Legnica(Piast) arms
duchy of Kuyavia: Voivodeship of Kuyavia arms
Inowroclaw: Voivodeship of Dobrzyn arms
Brsezc: Pobog arms(red version)
Kulm/Chelmno: Kulm arms in the Banderia Prutenorum
Duchy of Sandomierz:Voivodeship of Sandomierz
Sandomierz: Odrowaz arms
Wislica: Pilawa arms, could also use Lis arms
Duchy of Krakow
Krakow: Topor arms could also use Gryfici/Swiebodzic
Sandec: Janina(Piotr Wydzga lord of Czorsztyn and Rytro)/Zgraja  or Kurozwecki/Poraj arms
Leczyca: Voivodeship of Leczyca arms
Sieradz: Voivodeship of Sieradz arms
Duchy of Masovia: dukes of Masovia arms
Plock: Kurowie arms
Czersk: Janusz I of Masovia arms
Rawa: Rawicz arms

Kingdom of Halych
Duchy of Belz: dukes of Belz arms
Belz
Chelm: Jelita/Zamoyski arms
Premyshl: Herburt arms(castellans of Sanok)
Podlaise:Kosciesza arms

Kingdom of Lithuania:
Duchy of Trakai
Trakai: Kesgaila/Zadora arms

Grodno: Pac/Gozdawa arms
Vilinius: Gieralt arms?
